11111111111111111111111
10000000000111101001001
11010100100100001100011
10010010010010101001001
10111011011000101100001
10100000101101000110111
10100001011000110000111
10011100001001100001111
11P01101011011001011111
10CE0010000100000000011
11101101101001111000011
11111111111111111111111