111111111111111111111111111111111111111
10000000P1C000000000000000000000000CCC1
101111111101111111111111111101111111001
10000000000000000000000000010000CCCCC01
111111111111111111111111110100000000001
100000000000000000000000000101111111111
101111111111111111110111111E0000000CCC1
100000000000001000000001000000000000001
100000000000001011111111111CC1111111111
100000000CCCCC10000000000000000000CC001
111111111111111111111111111111111111111