1111111111111111111111111111111111
1000C000C0000000C00000000000000001
1100010100110000101001001000010101
10100111111011100010010100C0010011
10000000001001C1000000000000000001
10000C00001001CE0000C00P00C0000001
10000000001001C1000000000000000001
1111111111111111111111111111111111
